111111111111111111
100000000000000001
100000000000000001
100000000000000001
100000000000000001
100000021000000001
100000010000000001
100000000000000001
100000000000000001
100001000000000001
100001001000000001
100000101000000001
100000010000000001
100000000000000001
100000000000000001
100000000000000001
100000001000000001
100000001000000001
100000001000000001
100000001000000001
100000001000000001
100000001000000001
100000000000000001
111111111111111111