11111111111111
10000000000001
10000000000001
10050000000001
10010000000001
10100000000001
10000000000001
11111231517811