11111111111111
10000000000001
10000000000101
10050000000101
10010000000101
10100001110101
10000000000001
11111234567811