313131313131313131
100000000000000001
200000000000000001
300000010000000001
400000100000000001
500000000000000001
600000000000000001
700000000000000001
800000000000000001
900000000000000001
100000000000000001
111111111111111111